1111111
1E0CPC1
1000001
1111111
