1111111111111111111
1E0CPC1111111111111
1000000000000000001
1111000000100000001
1111111111111111111
