111111
111111
11CPC1
11E111
111111
